" Proxy Group"	"策略组"
" Proxy"	"节点"
" is\n      launching for editing.\n    ")]),e._v(" "),n("div",[e._v("Close the editing file to Save.")]	" 正在启动...\n    ")]),e._v(" "),n("div",[e._v("关闭编辑中的文件以保存。")]
") has been released, download?"	") 已发布，是否下载？"
")."	") 。"
"Active Connections"	"活动连接"
"Add"	"添加"
"Advertisement"	"广告"
"All","TCP","UDP"	"全部","TCP","UDP"
"Allow LAN"	"允许局域网连接"
"AlterId"	"AlterId"
"Appearance"	"外观"
"Break When Mode Change"	"切换模式时断开"
"Break When Profile Change"	"切换配置时断开"
"Break When Proxy Change"	"切换节点时断开"
"Bypass Domain/IPNet"	"跳过域名/IP"
"Cancel"	"取消"
"Cannot set system proxy"	"无法设置系统代理"
"Chains"	"链"
"Change information"	"修改信息"
"Check"	"测试"
"Child Processes"	"子进程"
"Choose outbound interface",message:"only works when TAP mode enabled"	"选择出站接口",message:"仅在TAP模式开启时生效"
"Clear"	"清空"
"Close All"	"关闭所有"
"Connected"	"已连接"
"Connection Breaking Strategy"	"连接断开策略"
"Connection Info"	"连接信息"
"Connections"	"连接"
"Content"	"匹配内容"
"Copy profile"	"复制配置"
"Copy proxy setting commands"	"复制终端代理命令"
"Core Version"	"内核版本"
"Could not connect to Clash Core"	"无法连接到 Clash 内核"
"Could not switch to this profile!"	"无法切换到此配置文件！错误："
"Create a new rule"	"创建一条新规则"
"Dark"	"暗黑"
"Default Icon Path"	"默认图标路径"
"Default","Latency","Alphabet"	"默认","延迟","字母"
"Destination"	"目的地址"
"Detected: "	"已检测到："
"Developer"	"开发者"
"Dial ["	"对 "
"Direct Mode"	"直连模式"
"Disconnected"	"未连接"
"Display Type"	"显示类型"
"Do not show this dialog anymore"	"不再显示此窗口"
"Docs"	"文档"
"Domain or IPNet"	"域名或IP"
"Download GeoIP database failed with error: "	"下载GeoIP数据库时出现错误："
"Download Speed"	"下载速度"
"Download Traffic"	"下载流量"
"Download and install (might take a few minutes)"	"下载并安装 (可能需要几分钟) "
"Download from a URL"	"填入订阅地址"
"Download profile failed with error: "	"配置下载失败，错误："
"Download profile failed with error: HTTP Response Status Code("	"配置下载失败，HTTP响应状态码 ()"
"Download"	"下载"
"Download","Copy URL","Cancel"	"下载","复制链接","取消"
"Downloading"	"下载中..."
"Drag to sort or add to the list on the right."	"拖动以排序或添加到右侧列表。"
"Duplicate profile"	"创建副本"
"Edit in Text Mode"	"文本模式下编辑"
"Edit in text mode"	"文本模式下编辑"
"Edit policies"	"编辑节点"
"Edit profile information"	"编辑配置信息"
"Edit rules"	"编辑规则"
"Edit"	"编辑"
"Editor"	"编辑器"
"Empty log list"	"无日志记录"
"Error!"	"下载出错！"
"Error"	"错误"
"Feedback"	"反馈"
"Folder Path"	"文件夹路径"
"Follow System Theme"	"跟随系统主题"
"Font Family"	"字体"
"General YAML"	"基础配置文件"
"General"	"常规"
"GeoIP Database"	"GeoIP 数据库"
"Global Mode"	"全局模式"
"Go to URL"	"打开链接"
"Group Name"	"策略组名称"
"HTTP Port"	"HTTP 端口"
"Health Check"	"连通性测试"
"Host"	"目标节点"
"ICO(.ico) asset path"	"图标(.ico)资源路径"
"Ignore this version"	"忽略此版本"
"Import"	"导入"
"Input a new file name"	"输入新的备注"
"Input fields are alternative"	"密钥和下载链接择一填入"
"Install"	"安装"
"Installing"	"安装中"
"Interface Name"	"接口名"
"Keep Disconnected"	"保留关闭的连接"
"Last Updated: "	"上次更新："
"Latency Test Timeout"	"延迟测试超时阈值"
"Latency Test URL"	"延迟测试URL"
"Light"	"亮白"
"Loading..."	"加载中..."
"Log Level"	"日志级别"
"Logs"	"日志"
"MaxMind User License Key"	"MaxMind 用户许可密钥"
"Mixin"	"混合模式"
"Mode Change"	"切换代理模式"
"Name"	"名称"
"Name"	"备注"
"New version("	"新版本 ("
"New"	"新建"
"No new updates found."	"未找到新版本。"
"No provider in this profile."	"此配置不包含代理集。"
"No"	"取消"
"None","Chain","All"	"否","仅链","所有"
"Note"	"注意"
"Notifications"	"通知"
"OK"	"确认"
"Obfs (Optional, tls or http)"	"Obfs（可选, tls 或 http）"
"Obfs-host (Optional)"	"Obfs-host（可选）"
"Open Folder"	"打开文件夹"
"Open logs folder"	"打开日志文件夹"
"Open terminal with proxy set up"	"打开终端并配置好终端代理"
"Order By"	"排序方式"
"Outbound"	"出站"
"Override detected value"	"覆写检测值"
"PAC Content"	"PAC 内容"
"Parsers info"	"解析器信息"
"Parsers"	"解析器"
"Password (Optional)"	"密码（可选）"
"Password"	"密码"
"Path"	"路径"
"Please confirm"	"请确认"
"Port"	"端口"
"Processes"	"进程"
"Profile Change"	"切换配置文件"
"Profile Mixin"	"混合配置"
"Profiles folder path"	"配置文件路径"
"Profiles"	"配置"
"Proxies"	"代理"
"Proxy Change"	"切换代理节点"
"Proxy Groups"	"策略组"
"Proxy Item Width"	"节点最小宽度"
"Proxy Name"	"节点名称"
"Proxy Providers"	"代理集"
"Proxy or Policy"	"节点或策略组"
"Record"	"录入"
"Release Note:\r\n"	"发布记录：\r\n"
"Relevance"	"相关链接"
"Remove"	"移除"
"Request Headers"	"请求头"
"Request Logs"	"请求日志"
"Requests in "+e._s(this.mode)+" mode"	e._s(this.mode)+" 模式下访问请求"
"Reset All Settings"	"重置所有配置项"
"Restarting core..."	"内核重启中..."
"Rule Mode"	"规则模式"
"Rule"	"规则"
"SOCKS5 Port"	"SOCKS5 端口"
"Save"	"保存"
"Script Mode"	"脚本模式"
"Select After Updated"	"更新后启用"
"Select a terminal"	"选择终端类型"
"Select"	"选择"
"Server"	"服务器地址"
"Setting DNS..."	"设置DNS..."
"Settings"	"设置"
"Shortcuts"	"快捷键"
"Show Filter"	"显示过滤器"
"Show New Version Icon"	"有新版本时提醒"
"Silent Mode"	"静默模式"
"Skip Cert Verify"	"跳过证书验证"
"Sorry"	"抱歉"
"Source"	"发起者"
"Special Proxies"	"特殊节点"
"Start with Windows"	"开机启动"
"Start"	"开始"
"Stop"	"停止"
"Success!"	"下载成功！"
"Switching profile failed with status: "	"配置文件切换失败，错误："
"System Proxy Bypass"	"系统代理白名单"
"System Proxy On Icon Path"	"系统代理开启的图标路径"
"System Proxy"	"系统代理"
"TAP Device"	"虚拟网卡设备"
"TAP device management"	"TAP 设备管理"
"Test latency"	"延迟测试"
"Thanks"	"鸣谢"
"Theme"	"主题"
"Time"	"时间"
"Timeout"	"超时"
"Top 100 matching rules("	"前一百条匹配规则（总条数："
"Total:	"总共:
"Tray"	"托盘"
"Try to repair"	"尝试修复错误"
"Type"	"匹配类型"
"Type"	"类型"
"URL"	"地址"
"UUID"	"UUID"
"UWP Loopback"	"解除UWP回环"
"Uninstalling"	"卸载中"
"Update GeoIP database"	"更新 GeoIP 数据库"
"Update Interval (hour)"	"更新间隔（小时）"
"Update Interval must be an integer"	"更新间隔必须是一个整数"
"Update this profile"	"更新配置"
"Update"	"更新"
"Updating GeoIP database is not allowed in CFW, please do it manually."	"无法通过 CFW 更新 GeoIP 数据库，请手动更新并替换文件。"
"Updating... ("	"更新中... ("
"Updating... (0%)"	"更新中... (0%)"
"Upload Speed"	"上传速度"
"Upload Traffic"	"上传流量"
"Upload"	"上传"
"User Name (Optional)"	"用户名（可选）"
"We found a new version for you, install it?"	"发现新版本，是否安装？"
"Yes"	"确认"
"[ Reset ]"	"[ 重置 ]"
"\n                Cancel	"\n                取消
"\n              Content	"\n              内容
"\n            Last Updated	"\n            上次更新
"\n        Add	"\n        添加
"\n        Cancel	"\n        取消
"] failed"	" 拨号失败"
"check for app update, current: "	"检查软件更新，当前版本："
"config.yaml and country.mmdb will be removed."	"config.yaml and country.mmdb 将会被删除。"
"confirm confirm-right"	"confirm confirm-right",style:{"white-space":"nowrap"}
"eg: google.com"	"例：google.com"
"fail to load general config.yaml with error: "	"加载通用配置文件——config.yaml 失败，错误为："
"first luanch, creating config.yaml..."	"初次启动，创建 config.yaml 文件..."
"fiter by keywords"	"关键词过滤"
"mode:	"模式:
"oops, got an error here"	"糟糕，发生了一个错误"
"recording..."	"记录中..."
"下载","Copy URL","取消"	"下载","复制链接","取消"
Are you sure to delete	你确定要删除
Close All	关闭全部
Home Directory	配置文件目录
If the installation box pops up, keep clicking "Next" until the installation is complete.	如果弹出安装窗口，请继续点击“Next”直到完成安装。
Logs Folder	查看日志文件
Mixin allows you to overwrite the original configuration file.	启用混合模式以覆写原配置文件。
Refresh your browser to make requests.	刷新浏览器以发起请求。
e._v("Launch Helper")	e._v("启动")
e._v("Manage")	e._v("管理")
e._v("New"	e._v("新"
e._v("Text Mode Edit")	e._v("编辑")
e._v("\n        Launch Helper\n      ")	e._v("\n        启动\n      ")
e._v("\n        Manage\n      ")	e._v("\n        管理\n      ")
e._v("\n        Open Folder\n      ")	e._v("\n        打开\n      ")
e._v("\n        Text Mode Edit\n      ")	e._v("\n        编辑\n      ")
e._v("新建"	e._v("新"
i+" had been released"	"版本 "+i+" 已发布"
message:'An adapter named "cfw-tap" will route your data into clash.	message:'本机数据将会被名为 "cfw-tap" 的网络适配器传递给 Clash 。
title:"Found ".concat(n.length," matching parsers"	title:"发现 ".concat(n.length," 个匹配的解析器"
title:"You are awesome",content:"The current version is up to date."	title:"你真棒",content:"已经是最新版本。"
